########
#      D
#      #
#      #
########
%
true	OfHall	12 1
%
%
5 2